static const goodsHome = '/goods_home';
static const goodsItemDetail = '/goods_item_detail';
static const msgChatRoom = '/msg_chat_room';
static const msgChatRoomWidgets = '/msg_chat_room_widgets';
static const msgMsgIndex = '/msg_msg_index';
static const myMyAddAddress = '/my_my_add_address';
static const myMyAddAddressWidgets = '/my_my_add_address_widgets';
static const myMyAddress = '/my_my_address';
static const myMyAddressWidgets = '/my_my_address_widgets';
static const myMyAddresses = '/my_my_addresses';
static const myMyEditAddress = '/my_my_edit_address';
static const myMyEditAddressWidgets = '/my_my_edit_address_widgets';
static const myMyEditItem = '/my_my_edit_item';
static const myMyIndex = '/my_my_index';
static const myMyIndexWidgets = '/my_my_index_widgets';
static const myMyItems = '/my_my_items';
static const myMyItemsWidgets = '/my_my_items_widgets';
static const myMyProfile = '/my_my_profile';
static const myMyProfileWidgets = '/my_my_profile_widgets';
static const orderCartIndex = '/order_cart_index';
static const orderOrderIndex = '/order_order_index';
static const postAlbum = '/post_album';
static const postAlbumEdit = '/post_album_edit';
static const postPostItem = '/post_post_item';
static const postPostItemWidgets = '/post_post_item_widgets';
static const postPostShort = '/post_post_short';
static const postPostShortWidgets = '/post_post_short_widgets';
static const postPriceEdit = '/post_price_edit';
static const postSaEdit = '/post_sa_edit';
static const postSkuEdit = '/post_sku_edit';
static const stylesButtons = '/styles_buttons';
static const stylesIcon = '/styles_icon';
static const stylesImage = '/styles_image';
static const stylesInputs = '/styles_inputs';
static const stylesStylesIndex = '/styles_styles_index';
static const stylesText = '/styles_text';
static const stylesTextForm = '/styles_text_form';
static const systemLogin = '/system_login';
static const systemLoginWithLine = '/system_login_with_line';
static const systemMain = '/system_main';
static const systemSplash = '/system_splash';
static const systemWelcome = '/system_welcome';
